3333333333
2000000002
2000000002
2000000002
1000000001
2000000002
2000000002
2000000002
2000000002
3333333333