1111111111
1000000001
1000000001
1000000001
1001100001
1001100001
1001100001
1000000001
1011110001
1111111111